Columns: 30
Rows: 20
000000000000000000000000002000
000000000000000000000000112100
000000000011110000000000112100
000000000011110000000000112100
000000000011110000000000112100
000000000011110000000000002000
000000000000003434343434002000
000000000000005656565656002000
000000000000003400000000002000
000000000000005600000000002000
000000000000003400000000002000
000000000000005600000000002000
000000343434343400000000002000
000000565656565600000000002000
000000000000000022222222222000
000000000000000000000000002000
000000000000000000000000002000
000000000000000000000000002000
000000000000000022222222222000
000000000000000000000000000000