Columns: 30
Rows: 20
000000000000000000034000000000
000000000000000000056000120000
000000000011110000000000120000
000000000011110000000000120000
000000000011110343400000120000
000000000011110565600000020000
000000000000000000000000020000
000000000000000000000000020000
000002222222222222220000020000
000002000222220110000000020000
000002000000000110000000021111
000002000000000110000000021111
000002000022222222222222221111
000002000020000000000000000000
000002000020000111111100000000
000002000020000111111100000000
000002222220000111111100000000
000000000000000111111100000000
000000000000000111111100000000
000000000000000000000000000000